10x7
#######
#   * #
# ### #
#  *  #
# # # #
# ### #

# ### #
#  +  #
#######
