10x7
#######
#     #
# ### #
#     #
# # # #
# ### #
       
# ### #
#  +  #
#######