8x7
#######
#     #
# ### #
#     #
       
# ### #
#  +  #
#######