10x7
#######
#   * #
# ### #
# *   #
# # # #
# ###*#

# ### #
#  +  #
#######
